ee op Shits А a eee SR Le EO ЕЕ ЕР a А “ _ ПРАВИТЕЛЬСТВО МОСКВЫ | _ a КОМИТЕТ ГОСУДАРСТВЕННОГО СТРОИТЕЛЬНОГО НАДЗОРА ie о ГОРОДА МОСКВЫ , те Г a re .'МОСГОССТРОИНАДЗОР) [3587 2) _ “s+. + yn. Bpsucxaa, o. 9. Mocxsa, 121059; renedou/phaxe: (495) 240-03-12; e-mail: info@stroinadzortt, http: //www.stroinadzor.ru be о. и». РЕГИСТРАЦИОННЫЙ ке 2 FP уметь 7 И ме dis ng Кому ГУП города Москвы «Московский — ee Рот ' ; 7 pee Beal mas Hoantce ордена Ленина и ордена Трудового a bel Z (наименование застройщика, (фамилия, имя, отчество — для |: У И i 7 граждан, полное наименование организации ae a Teno Ne 22/892 , Красного Знамени имени 2 iS В.И. Ленина» и a 129110, г. Москва, проспект-Мира, дом 46, eB = для юридических ce \ Дело № 22/892 лиц). его почтовый индекс и адрес) >. т cee See) и 3) о , , а a ^ РАЗРЕШЕНИЕ | _ Be НА ВВОД ОБЪЕКТА В ЭКСПЛУАТАЦИЮ ee || Ne RU77129095-000473 ` ee ie = 1.7 Комитет государственного строительного надзора города Москвы, руководствуясь Es С статьей 55 Градостроительного кодекса Российской Федерации, разрешает ввод! a в эксплуатацию построенного, рекенетруиреваннеге-еотремонтированнюоее объекта eS — of ’ у (ненужное зачеркнуть) ` be een) . Ga a капитального строительства: _Митинско-Строгинская линия. a oe (наименование объекта капитального строительства в соответствии (ft, ' be a ` метрополитена первая очередь пускового комплекса: линия от станции / eS a _, «Парк Победы» до станции «Строгино» ‚ npotmxennoctsro 11,49 kM." ce a и т ^ с проектной документацией) ТИ 5 ee we, 7 Ss —| ` расположенного по. адресу: г. Москва, ЗАО, СЗАО, станция метро «Парк Нобеды» > ie О 5: 1. 27.4. (полный адрес объекта капитального строительства с указанием субъекта = a ° : до станции метро «Строгино». _ ИИ a ce eee : и , > ioe ed “ , ‚ " Ws eS ‚ строительный адрес: “ЗАО, Дорогомилово, СЗАО, станция метро "Парк Победы be Ep / Российской Федерации, административного района и т.д. или строительный адрес).’ и _ a ‚ до станции метро "Строгино" / И = ри, 1 ros ies	
	
	ия eet et ЕЯ a Be ие ng ak One	
	
	
	
Ян м Be Pe ae Bo rhe ies tee ee BE Be ве Be Bal	
ЙН,	
ee me Re he me	_—^ во. РЕГИСТРАЦИОННЫЙ ИМ тю, uF WS = А № Hy ' а эт : “ Подпись Zt	
Л	
>	
a ma fed Я	
ее 25)	
	

ey °— Продолжение разрешения > et Te, (|. 2. Сведения об объекте 1 „| | Наименование показате Е `____ Т.Общие по #4| „| Строительный объем всего	
НЕ ОЕ НЕ Е ЕВЕ SAREE EERE ROS ISDS i ed ` Продолжение разрешения на ввод OObeKTa B IKCHAyaTAWHIO Ne RU77129095-000473 7”, 2 eae ob 8 ree ’ , „7. = . 4 oa ee | .2. Сведения об объекте капитального строительства | ES Bel ee т . ге Ee ` > “ue ул ° eee oe Наименование показателя Единица По проекту '| Фактически | a ne a измерения \ Ss ead Г.Общие показатели вводимого в эксплуатацию объекта __ Е т = —T ce Общая площадь о м р a | one nee HOM , we -. ; | | a й : 7 Be = | | пристроенных помещений ОНИ В e о” в ert . ` -. . > , ’ row pant ae ., .7 у , oe . a8 -, , ' bt _ |. | Количество зданий * т. Ae ee 7 7 / ARS a и рии os _П.Нежилые объекты a, о Е. ie : : A : са Heal ae Bes „И iS Объекты непроизводственного назначения (школы, больницы, детские сады, a fees : : Be ии Lo объекты культуры, спорта и т. д.) , Ш eat : > | т , 7 : ee (eee a eh : el ee = п а К И 7 Е ae Протяженность линии ^ doco. . | с ь ap 1 i a a ` | метрополитена KM — 41,491. 12,49 aS ee ' | Количество станций комплекс” 2 г о 2.” |. lea) | втом числе: ^^. . f i ‘ pa lia} | KomM4ecTBO NepecaOuHBIX | ° (т. : о р Bee комплексов на станцию "| ШТ 1 у: ‘Yo a jee | «Кунцевская» ,‚. ` Ls (и: Cae Ee и 7.7.5. 9.” ^` Объекты производственного назначения, .`’; “аи: п И | an oe oo? . я ох в af as Seu a4 [Mounier СЁ |: | Производительность ‚7х 2 Bet ; <” ete ee ” , . > о, а ae © |: Материалы кровли о PT ee 1 т.т” В Объекты жилищного строительства | 2 PE ee a RT ‚ ии Tf ( } : о ett | a att и. т ta Te и _о ия hott	Яя		WERE, 5 |:	
_^ Продолжение разреш ения на ввод объекта в эксплуатацию № К077129095-000473 7, . ; wo ПУ и" ‘ . Г “ 7 he | : von © 7 , ". . ’ oe °.2. Сведения об объекте капитального строительства о Наименование показателя Единица По проекту '| о Фактичес ne 51, измерения Т.Общие показатели вводимого в эксплуатацию объекта _ Пт ООО ООО ПИ ‚ | Площадь встроено‘| км . “|. ион, а: |. Щи пристроенных помещений Poe Oe pe fet и -. П.Нежилые объекты a oy ^ . , Loe . » 7 4 ‘ , и Объекты непроизводственного назначения (школы, больницы, детские сах И oa объекты культуры, спорта и т. д.) , Кено мет т ООО СООО ООО ПО ee fe of ao | ` етропо . — 7 метрополитена KM ; 11,49 \ , 12,49 „^ | Количество станций, | комплекс” 2’ А a ” [ptomanene: . о: poo. . ^^ | Станция "Кунцевская" _ о: _ [Станция "Спогино" | Количество пересадочных (о. : А ` | комплексов на станцию °°" | Wr -. Те То | «Кунцевская» ‚. “ s yhoo. 7. or и | 7. 9.” ^ Объекты производетвенного назначения, ›”'; “о. ни гого.” ОО Объекты жилищного строительства oo hal ye И а Аа hE TINE IT ne IE 7. А	
ue ee ey	
Наименование показателя	Единица измерения	_ По проекту ’	‚ Фактически |	
Т.Общие показатели вводимого в эксплуатацию объекта _. |	
Строительный объем всего ‘^	куб.м			
Reet ВЯ ва ene ey eel и sa} ped Sed Sei eed Иа Е ня рок дея Sed Bad BSS ва gaia ed wey И в Shap i Bae ay 2h an ioe ae See Bed _ м“ На Ве И На НЯ ia el Hd + i a ea ВН eae gee gore ey	куб.м °`!.	+ s 	
в том числе надземной части? `	
7,’ 4's ” +. 7 ee, - a ee ae ra * fae р 1 д 4 4		
Общая площадь. ^‘*\’ ; с	КВ.М* ve		; ~ _ 7	
., Г,” ’ р .	 \ t		
Площадь встроеноSO пристроенных помещений	KBM 5. ^ ди am г, иена	у ^	 , Seay a wet? oS ., a 2 , 4 ‘	‘ ” a oat ae	a co, rou ‘ . , 
Количество зданий и	штук .	' 2 ~ a) yy -. ты " ‘|	
^^ ` ., “yy	 у	
	
Объекты непроизводственного назначения (школы, больницы, детские сады, ° и oa объекты культуры, спорта и т. д.) , ,	
у `	И ‚|	
Количество мест \ .	-		
Количество посещений 		\ |	
Вместимость 		-|	
Протяженность линии *“ метрополитена KM	— 149.	| a г 12,49 ‘ |	
Количество станций, | в том числе: ‘^^ .” .	комплекс” та 7	2.		
Станция "Кунцевская" |	комплекс 7 .1 _,	
Станция "Строгино" vo	комплекс 1 -	
Количество пересадочных комплексов на станцию °‘`’. «Кунцевская» ‚. ms .,	шт т	“4 ay	ол	
р цв 4 и ate oN Uo te т feat 1 анты , о tay an a "oe , aoe tle ‚van . : we `, и та, ,	
ито. 9. .” ^ Объекты производственного назначения, © “27”.	
Мощность . р J co nn al? > ` ‘	+ о ce . а, о	
Производительность ©, « ~	 ”	um ate	
Протяженность. ^./.) .°			р el % * amt ie ae	
Материалы фундаментов °.		“ ‘	о ‘yg (я ny eng n	
“Материалы стен» 57 г. 7:	22“ у , >	ие.	“, roe, sgt te wg aw	
Материалы перекрытий .’`”.--		„7 -, > te	, Яша > we ag eee и	
Материалы кровли. ,^“’. ^“””,	у „(и ° .” ° 2 -	’ из . ‘| _ & г	” Ee. tee eek ` т м ИА, 
ies fees! рая Be on	

= Продолжение разрешения на ввод объекта в эксплуатацию № В077129095-000473 LB = ea Общая площадь жилых / , , |. =| | помещений (за исключением ` “ eS eg KB.M a eel | | Gankonos, soypKnit, BepaHy \ Pe eed tees — | | итеррае) — be ||| [втом числе: О ПО ПИ || | более чем 4-комнатные штук/ кв.м = ee east es) | Общая площадь жилых = ea помещений (с учетом балконов, | KB.M = 2 лоджий, веранд и террас) ‘ eS © |Marepanagyumamenron | —SSiP SSS all -| Материалы перекрытий te eee Wat esl peal ie ; bas tel ГУ. Стоимость строительства ie 2s Стоимость строительства тыс. рублей 1099593,0 1099593,0 Е = | | объекта — всего; в ценах 1991 г. в ценах 1991 г. г т > Bat ine в т.ч, пусковой комплекс 401128,0 401128,0 ыы Tees , И ee ‚| / в ценах 1991 г. в ценах 1991 г. a Bor = at = в том числе тыс. рублей 840902,0 840902,0 ce ee строительно-монтажных работ в ценах 1991 г. в ценах 1991 г. ea gt Sl |. | вт.ч, пусковой комплекс 334849,0 334849,0 ce — , в ценах 1991 г. в ценах 1991 г. т EO `) be ee ‘ bee _ | Заме тёль ирёжседателя Комитета т | годдарежвенногобуроительного ee | Н`зораторрда ^ое`вы В.В. Ермолкин: . ed oe ee AL eo SMA ГАД ~ he 5 « BT yenexdop 200 Pr. a	| Продолжение разреш = Общая площадь жилы? = помещений (за исключ = балконов, лоджий, вер: =| | итеррас) S| Количество этажей a Количество секций a Количество квартир -Е 2 в том числе: | 1-комнатные a 2-комнатные _ 3-комнатные iS 4-комнатные _ более чем 4-комнатньк a Общая площадь жилы? = | | помещений (с учетом ¢ on rarnwnt penaun i Tenn:	
	
Общая площадь жилых и помещений (за исключением балконов, лоджий, веранд и террас) —_	КВ.М	`	é ot \	
Количество этажей	штук	у		
Количество секций	секций			
Количество квартир всего	штук/ кв.м			
в том числе.				
1-комнатные	IUTYyK/ KB.M	’ ~ и		
2-комнатные	штук/ кв.м			
3-комнатные	штук/ кв.м			
4-комнатные	штук/ кв.м		”	
более чем 4-комнатные	штук/ кв.м			
Общая площадь жилых помещений (с учетом балконов, лоджий, веранд и террас)	КВ.М			
Материалы фундаментов				
Материалы стен				
Материалы перекрытий		\		
Материалы кровли				
| ГУ. Стоимость строительства	
	
Стоимость строительства объекта — всего; в т.ч. пусковой комплекс тыс. рублей	1099593,0 в ценах 1991 г. 401128,0 „ вценах 1991 г.	1099593,0 в ценах 1991 г. 401128,0 в ценах 1991 г.	
в том числе строительно-монтажных работ в т.ч, пусковой комплекс	тыс. рублей	840902,0 в ценах 1991 г. 334849,0 в ценах 1991 г.	840902,0 в ценах 1991 г. 334849,0 в ценах 1991 г.	
	
	
	
= Be к. = =	э.о. срмолкиеЕ ; и \	
	
	
	
